4,3,2,2,1,3,1,1,2,1,1,1,1,1,2,1,1,1,2,1,3,1,1,4,1,1,1,2,1,1
4,1,1,1,3,2,1,1,1,1,1,1,1,1,1,1,1,1,1,1,1,1,1,1,1,1,1,1,2,1
1,1,2,1,3,2,1,1,1,1,1,1,1,1,2,1,1,1,1,1,1,1,1,1,2,1,1,1,1,1
1,1,1,1,1,1,1,1,1,1,1,1,1,1,1,1,1,1,1,3,1,1,1,2,1,1,1,1,1,1
1,4,2,2,1,1,1,1,1,1,1,1,1,1,1,3,1,3,2,1,1,1,10,1,1,1,1,1,1,1
4,1,1,1,1,1,1,1,1,1,1,1,1,1,1,1,1,1,1,10,10,1,1,1,1,1,1,1,1,1
1,1,1,1,1,1,1,1,1,1,1,1,2,1,1,1,4,1,1,1,1,1,1,3,1,1,1,1,2,1
2,1,1,1,1,1,1,1,1,1,1,1,1,1,1,1,1,1,1,1,1,1,1,1,1,1,1,1,1,2
1,1,2,1,1,1,1,1,1,1,1,1,1,1,2,1,2,1,1,1,1,1,1,1,1,1,1,1,1,1
2,1,1,1,1,1,1,1,1,1,1,1,1,1,1,1,1,1,2,1,1,1,1,2,1,1,1,1,1,1
1,1,1,1,2,1,2,1,1,1,1,1,1,1,1,1,1,1,1,1,1,1,1,1,1,1,1,1,2,1
1,1,3,1,1,1,1,1,1,10,10,1,1,2,1,1,1,1,2,1,1,1,1,1,1,1,1,1,1,1
1,1,1,1,1,2,1,1,1,1,10,1,1,1,1,1,1,1,2,1,1,1,1,1,1,1,10,10,1,1
1,1,1,1,1,1,1,1,1,1,1,2,2,1,2,2,1,1,1,1,2,1,1,1,1,1,1,1,1,1
1,1,1,1,1,1,1,1,2,1,2,3,1,1,1,9,2,1,1,1,1,1,1,1,1,1,1,3,2,1
1,1,1,1,1,1,1,1,1,1,1,4,2,1,1,1,1,1,1,1,1,1,2,1,1,2,1,1,1,1
1,1,1,1,1,2,1,1,1,2,1,1,1,1,2,1,2,1,1,1,1,1,1,1,1,1,1,1,1,1
1,1,1,2,1,1,1,1,2,10,1,1,2,1,1,1,1,2,1,1,1,1,1,2,1,2,1,1,1,1
4,1,1,1,1,1,1,2,1,2,2,1,2,1,1,2,1,1,1,1,2,1,1,1,1,1,1,1,1,2
1,2,1,1,1,1,2,1,1,10,1,1,1,1,1,1,1,2,1,1,1,1,1,2,2,1,1,1,1,1
1,1,1,1,2,1,1,1,1,10,1,1,1,1,1,1,1,1,1,1,1,1,1,1,1,1,1,1,1,1
1,1,1,1,1,1,1,1,1,1,10,1,1,1,1,1,1,1,1,1,1,1,1,1,1,1,1,1,1,1
4,1,2,1,1,1,1,1,1,10,10,10,1,1,1,1,1,1,2,1,1,1,1,1,2,1,1,1,1,1
1,1,2,1,1,1,1,1,1,10,10,10,10,2,1,1,10,10,1,4,1,2,1,1,1,2,1,1,1,1
2,1,1,1,1,1,1,1,2,1,10,10,2,1,1,1,1,1,1,1,1,2,1,2,1,1,2,1,1,1
1,1,4,1,1,1,2,1,1,3,10,10,1,1,1,1,1,1,1,1,1,1,1,1,1,2,1,10,10,1
1,1,1,1,1,1,1,1,1,1,1,1,1,1,1,1,1,1,1,2,1,1,1,1,2,1,1,1,1,3
1,1,1,1,1,3,1,1,1,1,1,1,1,10,1,1,1,1,1,1,2,1,1,1,1,1,1,1,1,3
1,2,1,1,2,1,1,1,1,1,1,1,1,10,1,1,1,1,1,2,1,2,1,2,1,1,1,1,1,1
2,1,1,1,1,1,1,1,2,1,1,1,1,1,1,1,1,1,3,1,1,1,1,1,1,1,1,1,1,1
